1,1;1,2;2,1;2,2;1,3;1,4;1,5;1,6;1,7;
5,5;5,6;6,5;6,6;
5,7;5,8;6,7;6,8;
7,7;7,8;8,7;8,8;
15,2;16,2;15,3;16,3;