19,8;20,8;23,8;24,8;19,9;20,9;23,9;24,9;19,10;20,10;23,10;24,10;19,11;20,11;23,11;24,11;5,12;6,12;19,12;20,12;23,12;24,12;5,13;6,13;19,13;20,13;23,13;24,13;5,14;6,14;13,14;14,14;15,14;16,14;17,14;18,14;19,14;20,14;23,14;24,14;23,15;24,15;23,16;24,16;13,17;14,17;15,17;16,17;17,17;18,17;19,17;20,17;23,17;24,17;13,18;14,18;13,19;14,19;19,20;20,20;19,21;20,21;3,22;4,22;
12,1;15,1;12,2;15,2;12,3;13,3;14,3;15,3;21,4;22,4;23,4;24,4;25,4;26,4;17,5;18,5;19,5;20,5;21,5;22,5;23,5;24,5;25,5;26,5;1,7;2,7;3,7;4,7;5,7;6,7;7,7;8,7;1,8;2,8;3,8;4,8;5,8;6,8;7,8;8,8;7,9;8,9;7,10;8,10;7,11;8,11;13,11;14,11;7,12;8,12;7,13;8,13;7,14;8,14;7,15;8,15;7,16;8,16;11,20;12,20;15,20;16,20;11,21;12,21;15,21;16,21;11,22;12,22;15,22;16,22;23,22;24,22;3,23;4,23;11,23;12,23;15,23;16,23;23,23;24,23;
1,1;2,1;1,2;2,2;1,3;2,3;1,4;2,4;1,9;2,9;1,10;2,10;1,11;2,11;1,12;2,12;16,12;17,12;18,12;1,13;2,13;16,13;17,13;18,13;1,14;2,14;1,15;2,15;1,16;2,16;1,17;2,17;1,18;2,18;
7,1;8,1;7,2;8,2;1,5;2,5;3,5;4,5;1,6;2,6;3,6;4,6;15,11;16,11;17,11;18,11;15,12;15,13;3,17;4,17;5,17;6,17;3,18;4,18;5,18;6,18;21,21;22,21;21,22;22,22;19,23;20,23;21,23;22,23;19,24;20,24;21,24;22,24;19,25;20,25;21,25;22,25;19,26;20,26;21,26;22,26;
3,1;4,1;5,1;6,1;3,2;4,2;5,2;6,2;13,9;14,9;15,9;16,9;17,9;18,9;13,10;14,10;15,10;16,10;17,10;18,10;13,12;14,12;13,13;14,13;5,21;6,21;5,22;6,22;5,23;6,23;7,23;8,23;5,24;6,24;7,24;8,24;5,25;6,25;7,25;8,25;5,26;6,26;7,26;8,26;